00000072222222600000000000000000000000000000000000
00000051111111400000000000072600000000000000000000
00000093333311800000000000051400000000000000000000
00000000000054000000000000093800000000000000000000
00000000000098000000000000000000000000000000000000